participant_id,word,response,length,silent_letters,shared_phonemes,total_difficulty
j,posicionar,,10,0,2,12
j,mosquitera,,10,1,2,13
j,inicio,,6,0,1,7
j,unidireccional,,14,0,1,15
j,soto,,4,0,1,5
j,hilo,,4,1,0,5
j,chistosamente,,13,0,2,15
j,hogar,,5,1,0,6
j,patilla,,7,0,1,8
j,aletear,,7,0,0,7
j,habanero,,8,1,1,10
j,barroquismo,,11,1,3,15
j,fiel,,4,0,0,4
j,linear,,6,0,0,6
j,voraz,,5,0,2,7
j,oratorio,,8,0,0,8
j,posteridad,,10,0,1,11
j,depositar,,9,0,1,10
j,yodo,,4,0,1,5
j,suajili,,7,0,2,9
j,proclamar,,9,0,0,9
j,ordenado,,8,0,0,8
j,hablado,,7,1,1,9
j,arpegiar,,8,0,1,9
